...................#
.....###########....
...............#....
...............#....
....................
....................
....................
....................
....................
....................
....................
....................
....................
.....#..............
.....#..............
.....##########.....
....................
....................
....................
#..................#